+--+--+--+--+--+--+--+--+
|p           |        | |
+  +--+--+  +  +--+  +  +
|  |     |  |     |     |
+  +  +  +  +--+  +--+  +
|     |  |  |     |  |  |
+--+  +  +  +  +--+  +  +
|     |           |  |  |
+  +  +--+--+--+--+  +  +
|  |        |     |     |
+  +  +--+  +  +  +  +--+
|     |     |  |       g|
+--+--+--+--+--+--+--+--+