+--+--+--+--+--+--+--+--+--+--+--+--+
|p    |     |        |           |  |
+  +  +  +--+  +--+  +  +--+--+  +  +
|  |  |     |     |  |        |     |
+  +  +--+  +--+  +  +--+--+  +--+  +
|        |     |  |        |  |     |
+--+  +  +--+  +  +--+  +  +  +--+--+
|     |  |     |     |  |        |  |
+--+  +  +  +--+  +  +  +--+--+  +  +
|  |  |     |     |     |     |     |
+  +  +--+  +  +--+--+--+  +  +--+  +
|        |     |     |     |     | g|
+--+--+--+--+--+--+--+--+--+--+--+--+
